Ordliste
Attglatt - bakglatt
Blæsarbe - blowjob
Bøggen - politi
Fetttjuv - casanova/sjarmør
Gra - kåt
Ganklæbb - Brunost
Gauder - Idiot
Hossolæsta - Ullsokker
Hukkukuln - ankelkulen
Itj - ikke
Kakskiv - brødskive
Klar - sliten
“Æ vart så klar sjø”
Karravolin - Å yppe
Kurinj - Dårlig/Fyllesjuk
Læms - lefse
Litjmuskveill - onsdag
Matinnj - Sulten
Sjøla/Sjøli`n - Mamma/pappa
Snavvel - snop
Sopinn - sulten
Veitj/kveite/tæv/taus - jente
Ørtævv - ørefik

Uttrykk
Sjø - Kortform for “skjønner du”. I samme stil som “se” som er kortform for “ser du” i Østfold og på Nordvestlandet. Trøndere legger til “sjø” på slutten av en setning for å forsterke budskapet. Kan også sammenlignes med “gitt” i østlandsområdet. Eksempelbruk: “Det va bra godt me en kopp karsk, sjø!”
Boksforlova - intimt samvær før “offentlig status”

Skjellsord
Fettkjærring - Et koseord brukt om noen som nettopp har lurt deg
Fettsjur - Et ludder
Slarinj - Penis
Sjettsjur - Ei skitten hore
Lortkaill - En mann som tar alle de styggeste damene
Rasstapp - En egoist
Fettoter/oterpung - Idiot om dame/mann
Kop - Treiging
Toillkuk - En skøyer eller idiot, kommer ann på tonefallet.
Spainnhøvv/Superkålhøvv - idiot
Blængdall - En som skryter uten å ha grunn til det
Kjærringjækel - Djevelkjærring
Brækkækkel - En som er så ekkel at man blir kvalm og spyr